NO ./t1.png
SO ./t1.png
WE ./t1.png
EA ./t1.png
C 225,0,0
F 240,233,133,144

1111111
1000001
100N001
1000001
1111111
