NO ./t1.png
SO ./t2.png
WE ./t3.png
EA ./t4.png

F 75,75,75                
C 47,55,66

1111111111111111111111111                     111111111111111111111111111
1000000000110000010000001                     100000000000000000010000001
1011000001110000000N00001                     101100000000000000010000001
1001000000000000000W00001                     100000000000000000010000001
1001000000100000010000001                     100000000000000000010000001
1011111100100000000000001111111111111111111111100000000000000010000000001
1000000001010000000000000000000000000000000000000000000000000000000000001
1001000000100000000000001111111110011111111111100000000100011000000000001
1011000001111111111100001      110011         100000001100100100000000001
1000000000110000010000001      100001         101100011100100100000000001
1001000000000000010000001     1000000111111111110000110100000100000000001
1011000001110000010000001     1000000000000000000001111100001000000110111
1000000000110000010000001      100001111111111110000000100010000001000001
1000000000000000000000001       10010000000000010000000100111110000100001
1111111111111111111101111111111111100000000000011111111110011111111111111
                   10000000000000000000000000000000000000001             
                   11111111111111111111111111111111111111111             
