NO ./src/images/mugiwara.png
SO ./src/images/shankusu.png
WE ./src/images/worldgov.png
EA ./src/images/sun.png

F 220,100,0
C 225,30,0

111111111111111
11100010110111011
11111000000N00011
11111111111111111
11111111111111111
