NO ./t1.png
SO ./t2.png
WE ./t3.png
EA ./t4.png
F 255,30,8
C 255,30,8
111111111111 11111111
100000100001 10000001
10N000000001 10000001
100000100001 10000001
100000100001 10000001
100000100001 10000001
100000100001 10000001
111111100001110000011
10000000000000000001
11111111111111111111
