NO ./t1.png
SO ./t1.png
WE ./t1.png
EA ./t1.png

F 220,100,0
C 225,30,0

11111111111111111
111111100000011111
1111111000N001111
11111110000001111
11111110000001111
11111111111111111
