NO ./t1.png
SO ./t2.png
WE ./t3.png
EA ./t4.png
F 255,30,8
C 255,30,8
1111111111111111
1111100000111111
1111100000111111
1111100N00000001
1111100000111111
1111111111111111
