EA ./images/n.png
SO ./images/yonkous.png
WE ./images/w.png
EA ./images/e.png

F 255,255,0
C 255,255,255

111111111111111
11100010110111011
11111000000N01
111110000000111111
11111111111111111



