NO ./t1.png
SO ./t1.png
WE ./t1.png
EA ./t1.png

F 220,100,0
C 225,30,0

      1111111111111111111111111111101111
      1000000000000011000000000000000001
      1011000000001111000000000000000001
      101010111000000000000000000000S001
1111111011000001110000000000011100111111
11110111111111011110001011101111000001
11010111111111110101111111010101010011
11111111111111111111111111111111111111
