NO ./t1.png
SO ./t1.png
WE ./t1.png
EA ./t1.png

F 220,100,0
C 225,30,0

111 111011111111
111 1110111111
111 1110000N11111
1111111111111
11111111111111
