NO ./src/images/mugiwara.png
SO ./src/images/shankusu.png
WE ./src/images/worldgov.png
EA ./src/images/sun.png

F 255,0,255
C 255,255,0

111111111111111
11100010110111011
11111000000N01
111110000000111111
11111111111111111



