NO ./images/newyonko.png
SO ./images/yonkous.png
WE ./images/shichibukais.png
EA ./images/wanted.png

F 111,0,0
C 111,0,111

111111111111111
11100010110111011
11111000000N01
111110000000111111
11111111111111111



