NO ./t1.png
SO ./t2.png
WE ./t3.png
EA ./t4.png

F 75,75,75                
C 47,55,66

        1111111111111111111111111
        1000000000110000000000001
        1011000001110000000000001
        1001000000000000000S00001
111111111011000001110000000000001
10000000001100000111011111111111Q
11110111111111011100000010001
11110111111111011101010010001
11000000110101011100000010001
10000000000000001100000010001
10000000000000001101010010001
1100000111010101111101111000111
11110111 1110101 101111010001
11111111 1111111 111111111111
