NO   ./t1.png   
SO 	./t1.png
WE ./t1.png			
EA 		./t1.png

F 225,0,0		   
C 			225,0,0

 11111
1N00111
1111111




