NO ./t1.png
C 47,55,66
EA ./t4.png
WE ./t3.png
SO ./t3.png

F 75,75,75                

       	01111111111111111111111111
        10000N0000110000000000001
        1011000001110000000000001
        1001000000000000000000000
111111111011000001110000000000001
100000000011000001110111111111111
11110111111111011100000010001
11110111111111011101010010001
11000000110101011100000010001
10000000000000001100000010001
10000000000000001101010010001
1100000111010101111101111000111
11110111 1110101 101111010001
11111111 1111111 111111111111
