NO   ./t1.png   
SO 	./t1.png
WE ./t1.png			
EA 		./t1.png


F 240,233,133
C 			225,0,0

111111111
100000001
1000N0001
111111111


