NO   ./t1.png   
SO 	./t1.png
WE ./t1.png			
EA 		./t1.png

F 240,233,i22
C 			225,0,0


cuidado com este mapa

 11111
1000111
 11111
 11111
1N00111
 11111


## ESTE MAPA EH UM TESTE PARA QUATRO COMPTNEJNTE
