NO ./t1.png
SO ./t1.png
WE ./t1.png
EA ./t1.png
F 240,233,133
C 225,0,0

1111111
10 0001
100N001
1000001
1111111
