NO ./images/newyonko.png
SO ./images/yonkous.png
WE ./images/shichibukais.png
EA ./images/wanted.png
C a25,0,0
F 240,233,133

1111111
1000001
100N001
1000001
1111111
