NO 	./t1.png
SO 	./t1.png
WE ./images/shichibukais.png  	
EA    ./t1.png	
F 	240,233,133			
C  225,0,0  

1111111
1000001
100N001
1000001
1111111
