SO ./t1.png
WE ./t1.png
F 240,233,133
EA ./t1.png
C 225,0,0
NO ./t1.png

1111111
1000001
100N001
1000001
1111111
